R 900 600
NO ./textures/wall_1.xpm
SO ./textures/wall_2.xpm
WE ./textures/wall_3.xpm
EA ./textures/wall_4.xpm

S ./textures/sprite_1.xpm
F 220,100,0
C 225,30,80

        1111111111111111111111111
        1000000000110000000000001
        1001100000110000000010001
        1000000000000000000000001
111111111010000000000000000000001
100000000011000001100011111111111
11100011111110011100000010001
11100011111110011101010010001
11000000110000011100000000201
10002000000000001100000000001
10000000000000001101010000001
11000001110101011111011110N01
11110111 1110101 101111010001
11111111 1111111 111111111111
