
WE textures/wall_3.xpm

R 1600 1200
    NO      textures/wall_7.xpm


 EA 	textures/wall_6.xpm
S textures/sprite_1.xpm


F     184  ,113,   39
C 	34,194,	224

	SO   textures/wall_2.xpm

       1111111111111111111111
       100000000011002000000111
11111111000000000000202000000001
100100220000000N000000000000011111
1011000000110000000000001000000001
11100000001100000100000110001111101
  11000111110000110000001000111111
11110001111100001100000010000001
11000000110100001100000010000001
10000000000000011000000100000011
10000002000000011111100010000001
1100000011000101    100000000001
11100011110001011111110000000001
10000000010000000000010010000001
10020000000000000000000000000001
10020202000000000000000202000001
10000000001101001110000020200001
10000111100100001 11000002000001
111111  111111111 11111111111111
